                                                              TTT                                                                                                        
                                                     $        ###                                                                                                        
                                                   $  $$      ###                                                                                                        
                                                 $    TT      ###                                                                                                        
                                               $      ##      ###                                                                                                        
                                             $ TTT    ##     $###                                                                                                        
                                           $   (#)    ##     $###                                                                                                        
                                           T          ##     $###             $                                                                                          
                                      ^^^^ #          ##     $###             T                                                                                          
                                  TTTTTTTTT#T         ##     $###             #                                                                                          
                                  (#########)         ##     $###             #^^^Y^^^Y^^^Y^Y^                                                                           
                               TTT                                            #TTTTTTTTTTTTTTTTT                                                                         
                               (#)                                         TTT#################)                                   /       $$$$$$$$$$$$$$$$$$$$$      YY 
                       $$$$$$                                           TTTTTTT                                            Y BBBBBBBBBBBBBBBBBBBBBBBBBBBBBBBBBBBB    BBBB
                      TTTTTTTT                                          (#####)                                           BBBBBBBBBBBBBBBBBBBBBBBBBBBBBBBBBBBBBBB    BBBB
                      (######)                                                                                         BBBBB                                            B
                                                                                                                                                                        B
  Y  !    Y  Y   Y       +O    Y Y   Y   Y  ++OO  Y Y Y  $$$$   $$$$$     Y   Y $$$$  /      9  $$$$   9     9  /       $$$$$$$$$  + + O                            F   B
TTTTTTTTTTTTTTTTTTTTTTTTTTTTTTTTTTTTTTTTTTTTTTTTTTTTTTTTTTTTTTTTTTTTTTTTTTTTTTTTTTTTTTTTT^^^TTTTTTTTTTTTTTTTTTTTTTTTTTTBBBBBBBBBBBBBBBBBBBBB^^^^BBBBBBBBBBBBBBBBBBBBB^^^B
#########################################################################################################################################################################